#map
12232113333333213231132313113223331111312212221323133331312333133111321233333312
11331123213122213131112112213221322111312311112111233222111313131112331322232112
31132223212321221121221313121323223112312223213132122123323311123212213233131332
12121112213111211132211323331212123331122232313211213113323132122223112222333332
31213222222313333122112122332322222113322132323333122113231112211123232221321312
31233321312123123332333223213332112333131333233312312213213211112131233223113112
21231311132132123213312311131121111323333213112312121311223222223331331313323222
12311123222231223313331222223211112311313311222132331132311233131323332223123312
12213313132221223331113312323221122223312311331132123122223221232111212112133322
22233231311221331213223323321113112211231333111111332332132222133313333231222112
23131133211231333131323323212122213313112122311222322112313312322322213222121132
13331122331322123221131322331222133132121232321311313222313212131312111313121122
11331111221313112123313312231132131311213113213231212233113132222122311333113122
31312311211312232123331132323322113313333332332231313232122233122331312121133232
33233332323122311212113223211123132121222311133221333231123221122322122321113122
32212333132312113132222112321321222323221321211321131123232312111111323323112212
21122212233221123123333112132131313112223222131113231212212321333222113332221232
33132312223213213221321211112113212123111111233132331312321111212232131321211322
32213321221322133331221113232311333133222311133132213122232111132212131321133212
22312231322131312322333211322123113231331313111212111323131333121211333231122212
11331123113332211123123312312311211311211311221211223121323122131123111131233132
32212212333321212222113323313231212322112131121322232312331213221313122323313132
12122231231322321133223123132232213231312122122122333312132212212312321323123212
11231312333122231112213221112222221212323223211121123213322321221322112231223132
22132131322333322131333313233211323121331323213212331331223312331131331323331332
23132322131333221212211111131311212322232212322312121311111323131211232313312322
33321133131133331232213221312211321131211323313121123113121211133322323122333112
33212133221313131213133332222213312322311311233321222332123232121133231233322212
32132212312132331313223132321223312231223122213211133123113112331311323333332322
12113221212113121222133121333211112123132321113321232331211223212133122123123212
33213322212332331112332211132323323133223121113222212311121311333221121313213232
22323311121121312221322223313223133313121233323111122323222213133311123233323212
12221132331311322323233213133331131321223321323222121211123111122121213131221312
21112123313313232211111121233111332313212322231111113321311332331113211332131312
32332113332313231333212133212233232231312111313223333132233313111322212311113222
11213112221121233212213232322231121333222231111211131212131221121223311212233212
13212323312133123233231321331222321222223211223111131322323212332111311313231232
23331221312123111211321311131331232132231221333222132312131311131132231123211332
11233123231332112313212321322323211133231223232112121223332132131122211122232232
13131211223213333111133332322323322232231212222221321133131333112311312331211112
31231111131231333223222133323232331233111321312221131211311211131111113121232112
23213112223223333111213332222122331112213332232322131112212123231312321121311332
32221331123133332323212221333312323333333333323323331232312322221312123312212112
21313111131232123311122321332322212312211111221322212132312132212211122112112122
31213232133131311312323331333212112211333323213233323122121312222312212322212132
11123113121222131222221212313211222222232322113113232231112323123221213112211222
33123113123123231233322113223323332112311222121232333233233332111313112233132112
23231123333221212323222331233211223132332331132132233333333331222211333122212232
22211131333221331112222332231312133132222122132111112122233332121122322113131132
23331223133232132321212221331112132112321232221213223132331332323121213332133312
33223332212211132112321112322321211212333131212223222131232113332133212332221222
11222122332222312313211131111123233322113221332311232331332222312232313311112112
21111321122122121222121122311123213312331213233131313222311112332313221222131312
11212313121233222112231213313133113223222221232232311332311131221132121222121122
11212111333213311211211213123222212323123322112331133321132323332311311133233122
22121221132133233323321222322111311312232333323332131233232113212212322211211312
12223312211213331132122131213221311323333123312321221211122323211121213311213222
12211213331333331332232331331132221331133312122322111111233113323222322223332132
22111113113321323312313332222232123313221211222112233223222321121223223131331332
33221212121331121113121132221221123113123322112112233233213233222131311132133132
31131232131131112311231312233133232223131311311321313212223211333322221211222132
33233311313323211313212313113313322312222233132322323232233223112211331231133232
33211223331212121222323322213221121322332223311322133113331313231321133223333112
13311312231122123133121112221122211111223231133121122233312122312132113221323132
11233111111132223221211112233211312121333311223212222311313111221331121333332232
11313221311333322333323111322222222113112212131113331131313311122332132111331232
21321311131233121213122223211233113213211333321121122212131332332131133213233322
11332233121133313322333312313112311332231333213222122211332133212231221122223322
12121211113211231231133222332122213332322231213213133123222113122122233133111112
13331212323331223212113133212232211333321221311222313213223211133323323322232132
33333312121212321232312212331312122213223111132233213212122211113123223121311212
31233113333311223223113121111123232211312232212233332122312221333121212132312232
12221332331223332311131122333131232121221313321313211232122323111221223213113222
33123321223222133322323122121323121313132211232131321331332122112111112132232132
11222333313223123311113131113231311332113113221331133132122111333321222333321232
11232223222231112232213323211112332333232122111123123232123231133221212211112112
31233313111321113221323231133313122131212222113123122213113213333222313222233122
13333313332332323111223313133231222131313313121222112123331122332132211232311332
11131223221311132211113211321223231321231332131112312131223313211223112133333122
11111111111111111111111111111111111111111111111111111111111111111111111111111110
#end_map

#flow
(1,2) (2,2) 5
(3,2) (2,2) 10
(2,1) (2,2) 15
(2,3) (2,2) 20
#end_flow



#taxi
No.1 2 2 (1,1)
No.2 2 2 (2,2)
No.3 2 2 (3,3)
No.4 2 2 (4,4)
No.5 2 2 (5,5)
No.6 2 2 (6,6)
#end_taxi

